* نیما یوشیج - بنیان‌گذار شعر نوین و ملقب به پدر شعر نو فارسی
* میرزا آقاخان نوری - مشهور به اعتمادالدوله دومین صدراعظم ناصرالدین شاه قاجار
* بهاءالله - رهبر دینی ایرانی، پایه‌گذار آیین بهایی
* شیخ فضل‌الله نوری - روحانی و مجتهد، از پیشروان جنبش مشروطه ایران
* حسن اسفندیاری - ملقب به محتشم‌السلطنه رئیس مجلس شورای ملی
* علی‌اکبر ناطق نوری - سیاستمدار و روحانی، رئیس مجلس شورای اسلامی
* غلامحسین بنان - استاد آواز هنرستان موسیقی تهران و بنیان‌گذار انجمن موسیقی ایران
* منوچهر ستوده - ایران‌شناس، جغرافی‌دان تاریخی، استاد دانشگاه تهران و پژوهشگر
* پرویز ناتل خانلری - ادیب، سیاست‌مدار، زبان‌شناس، نویسنده و شاعر
* میرزا حسین نوری - محدث و چهره سرشناس علمای شیعه در قرن چهاردهم هجری
* عبدالنبی نوری - حکیم و مجتهد ایرانی قرن چهاردهم
* غلامحسین صدیقی - استاد دانشگاه تهران و وزیر کشور ایران 
* موسی نوری اسفندیاری - دیپلمات و وزیر امور خارجه ایران
* حسینقلی صدرالسلطنه - معروف به حاجی واشنگتن نخستین فرستاده ایران به ایالات متحده آمریکا
* میرزا محمدرضاخان صدیق‌الدوله - از دولت‌مردان دوره قاجار
* جعفر یمین‌الممالک - معاونت وزارت خارجه و معاونت نخست وزیر دوره قاجار
* عبدالوهاب نظام‌الملک - وزیرلشکر و وزیر دادگستری قاجار، حاکم آذربایجان
* میرزا کاظم نظام‌الملک - وزیرلشکر و نایب صدراعظم قاجار، حاکم یزد
* محمد اسماعیل خان وکیل الملک - حاکم کرمان در دوره قاجار
* مرتضی‌قلی خان وکیل‌الملک - حاکم کرمان دوره قاجار
* ابوالحسن صدیقی - نقاش و مجسمه‌ساز برجستهٔ ایرانی و از شاگردان کمال‌الملک
* ابراهیم خواجه‌نوری - نویسنده، روانشناس، روزنامه‌نگار و سیاست‌مدار
* ملا علی نوری - از حکمای اسلامی
* مهدی نوری - از مبارزان جنبش مشروطه و روحانی شیعه
* فریدون صدیقی - مجسمه‌ساز ایرانی
* اسدالله یمین اسفندیاری - دیپلمات دوره قاجار و از کارگزاران فرهنگی دوره پهلوی
* عبدالله عدل اسفندیاری - نماینده مجلس شورای ملی و از کارگزاران اقتصادی دوره پهلوی
* شوکت‌الملوک خواجه‌نوری - نقاش ایرانی
* غلامعلی خواجه‌نوری - دیپلمات عصر پهلوی و کاردار سفارت ایران در ایتالیا
* ابوتراب خواجه‌نوری - مقام‌دار و مترجم ایرانی دورهٔ قاجار
* حسین شاه‌حسینی - معاون مهندس بازرگان و نخستین رئیس سازمان تربیت بدنی و کمیته ملی المپیک
* فهیمه اکبر - خواننده و نویسندهٔ
* صادق کیا - زبان‌شناس و متخصص زبان‌های باستانی و رئیس ادارهٔ فرهنگ عامه در وزارت فرهنگ و هنر
* زهرا کیا - پژوهشگر، نویسنده و مترجم زبان و ادبیات فارسی
* عبدالبهاء - سومین شخصیت محوری آیین بهائی
* یحیی صبح ازل - رهبر مذهبی ایرانی بابیه ازلی
* احمد ناطق نوری - سیاست‌مدار و رئیس فدراسیون بوکس ایران
* نورالدین کیانوری - فعال سیاسی ایرانی و دبیر اول کمیتهٔ مرکزی حزب توده ایران
* ابوالحسن عمیدی نوری - نویسنده و روزنامه‌نگار، از پایه‌گذاران جبههٔ ملی ایران
* رضا خواجه‌نوری - از یاران میرزا کوچک خان جنگلی و حاکم لاهیجان
* خدیجه ثقفی - همسر سید روح‌الله خمینی رهبر جمهوری اسلامی ایران
* حسن مرآت اسفندیاری - ماینده مجلس شورای ملی
* یحیی نوری - از روحانیون سر‌شناس تهران
* حسین خطیبی - ادیب، شخصیت سیاسی و نویسندهٔ
* سالار فاتح - از مبارزان و ملاکان و متنفذان مازندران
* رویا نونهالی - بازیگر و کارگردان تئاتر، سینما و تلویزیون
* همایون بهزادی - بازیکن و مربی فوتبال
* اسماعیل نوری‌علا - استاد دانشگاه، فعال سیاسی، نویسنده، کارگردان
* پرتو نوری‌علا - شاعر، بازیگر سینما، نویسنده، منتقد و عضو کانون نویسندگان
* افشین علا - شاعر و نویسنده
* حسن مشحون - نویسنده و موسیقی‌دان
* رحمان رضایی - بازیکن سابق تیم ملی و مربی فوتبال
* حامد کاویانپور - بازیکن سابق فوتبال
* محمود مشحون - رئیس فدراسیون بسکتبال ایران
* حنیف عمران‌زاده - بازیکن سابق و مربی فوتبال
* مهران دوستی - گویندهٔ رادیو و مجری برنامه‌های تلویزیونی
* کمال مشحون - بازیکن شابق تیم ملی بسکتبال
* حسن نیرزاده - از آموزگاران سرشناس ایران
* محسن یوسفی - بازیکن سابق فوتبال