* شیخ محمد کوهستانی - از فقهای بنام جهان تشیع و عالم زاهد
* خیرالنساء بیگم - ملکه همسر شاه محمد خدابنده و همچنین مادر شاه عباس یکم
* سردار رفیع یانسری - والی استرآباد در زمان قاجار
* سید عبدالکریم هاشمی‌نژاد - امام جمعه مشهد که در سال ۱۳۶۰ ترور شد
* احمد توکلی - سیاستمدار و اقتصاددان، نمایندهٔ مجلسِ شورای اسلامی، وزیرِ سابق کار و سخن‌گوی کابینهٔ محمدعلی رجائی
* علی یخکشی - پروفسور و فعال، نویسنده و استاد محیط زیست
* محمد اشرفی - از فقها، مراجع تقلید و عرفای شیعه
* موسی اشرفی - معروف به موسی خان، نماینده دوره چهاردهم مجلس ملی و از خیرین بهشهر
* محمد علی ییلاقی اشرفی - از سیاسیون تأثیرگذار و خیرین بهشهر و ریاست دو دوره شورای شهر بهشهر
* علی‌اصغر رحمانی خلیلی - نماینده ۳ دوره مجلس شورای اسلامی و معاونت پارلمانی وزارت ارشاد محد خاتمی
* داوود کشاورزیان - استاندار مازندران در دولت محمد خاتمی و معاونت ترابری وزارت راه در دولت حسن روحانی
* یدالله جهانگیری - جراح عمومی، رئیس سابق درمانگاه‌های صدا و سیما، دانشگاه تهران و مشاور محمد خاتمی
* احمدعلی مقیمی - نماینده دوره‌های هشتم و نهم مجلس شورای اسلامی و قائم مقام روزنامه جام جم
* سید صابر جباری - نماینده فقید خبرگان رهبری در استان مازندران و امام جمعه بهشهر
* غلامرضا حجتی اشرفی - نویشنده و پژوهشگر
* حسن بادکوبه ای - پروفسور و استاد تمام دانشگاه ملی نیویورک
* فرهاد دژپسند - وزیر امور اقتصادی و دارایی دولت حسن روحانی
* خسرو معصومی - کارگردان و نویسنده
* محمدرضا اسحاقی گرجی - موسیقی‌دان، و نوازندهٔ دوتار
* علی نبیان - معاون وزیر راه و شهرسازی دولت حسن روحانی
* منصور خورشیدی - شاعر
* علی شکوهی - سیاستمدار
* حسین کیانی - دارنده ۲ مقام قهرمانی تیر و کمان روی اسب جهان
* علی عمرانی - بازیگر سینما و تلویزیون
* محمد عمرانی - بازیگر سینما و تلویزیون
* بهنام احسان‌پور - قهرمان کشتی جوانان جهان
* فرزاد عموزاد - کشتی‌گیر تیم ملی
* اصغر بذری - قهرمان کشتی جهان
* رحمان عموزاد - کشتی‌گیر تیم ملی
* بهنام احسان‌پور - کشتی‌گیر تیم ملی
* موسی نبی‌پور - بازیکن تیم ملی بسکتبال
* جواد منافی - بازیکن سابق فوتبال
* محمد عاملی - وزنه‌بردار
* حسن اسماعیل پور - مجری و گوینده رادیو جوان
* محسن قرائی - کارگردان سینما و نویسنده